{
    "AD": "EUR",
    "AE": "AED",
    "AL": "ALL",
    "AT": "EUR",
    "AZ": "AZN",
    "BA": "BAM",
    "BE": "EUR",
    "BG": "BGN",
    "BH": "BHD",
    "BR": "BRL",
    "BY": "BYN",
    "CH": "CHF",
    "CR": "CRC",
    "CY": "EUR",
    "CZ": "CZK",
    "DE": "EUR",
    "DK": "DKK",
    "DO": "DOP",
    "EE": "EUR",
    "ES": "EUR",
    "FI": "EUR",
    "FO": "DKK",
    "FR": "EUR",
    "GB": "GBP",
    "GE": "GEL",
    "GI": "GIP",
    "GL": "DKK",
    "GR": "EUR",
    "GT": "GTQ",
    "HR": "EUR",
    "HU": "HUF",
    "IE": "EUR",
    "IL": "ILS",
    "IS": "ISK",
    "IT": "EUR",
    "JO": "JOD",
    "KW": "KWD",
    "KZ": "KZT",
    "LB": "LBP",
    "LC": "XCD",
    "LI": "CHF",
    "LT": "EUR",
    "LU": "EUR",
    "LV": "EUR",
    "MC": "EUR",
    "MD": "MDL",
    "ME": "EUR",
    "MK": "MKD",
    "MR": "MRU",
    "MT": "EUR",
    "MU": "MUR",
    "NL": "EUR",
    "NO": "NOK",
    "PK": "PKR",
    "PL": "PLN",
    "PS": "ILS",
    "PT": "EUR",
    "QA": "QAR",
    "RO": "RON",
    "RS": "RSD",
    "SA": "SAR",
    "SC": "SCR",
    "SE": "SEK",
    "SI": "EUR",
    "SK": "EUR",
    "SM": "EUR",
    "ST": "STN",
    "SV": "USD",
    "TL": "USD",
    "TN": "TND",
    "TR": "TRY",
    "UA": "UAH",
    "US": "USD",
    "VA": "EUR",
    "VG": "USD",
    "XK": "EUR",
    "IN": "INR",
    "SG": "SGD",
    "HK": "HKD",
    "CA": "CAD",
    "AU": "AUD"
}